#########
#E F    #
####### #
      # #
      # #
      # #######
      #    L S#
      #########
