#######
#S   L#
#     #
#     #
#     #
#F   E#
#######
