###########
#E F      #
####### ###
      # #
      # #
      # #######
      #    L S#
      #########
