############################
#S              #          #
#         L     #F         #
#               ####       #
#                          #
#                 #        #
#                 #        #
#                 #        #
###########       #        #
          #                #
          #           ######
          #           #
          #           #
###########          ##
#                   ##
#                 E##
####################
